

                   
                   
                   ╔════════════════════════════════════════════════════════════════════════════════════════════╗
                   ║                                                                                            ║
                   ║                                                                                            ║
                   ║                                                                                            ║
                   ║                                                                                            ║
                   ║                                                                                            ║
                   ║                                                                                            ║
                   ║                                                                                            ║
                   ║                                                                                            ║
                   ║                                                                                            ║
                   ║                                                                                            ║
                   ║                                                                                            ║
                   ║                                                                                            ║
                   ║                                                                                            ║
                   ║                                                                                            ║
                   ║                                                                                            ║
                   ║                                                                                            ║
                   ║                                                                                            ║
                   ║                                                                                            ║
                   ║                                                                                            ║
                   ║                                                                                            ║
                   ║                                                                                            ║
                   ║                                                                                            ║
                   ║                                                                                            ║
                   ║                                                                                            ║
                   ║                                                                                            ║
                   ║                                                                                            ║
                   ║                                                                                            ║
                   ║                                                                                            ║
                   ╚════════════════════════════════════════════════════════════════════════════════════════════╝